125
29
25 0 0 0 0 0 0 0 0 0 0 0 0 0 0 25 25 23 24 24 24 24 24 24 24 22 20 22 22 20 22 22 22 22 21 22 20 20 21 22 22 20 20 22 22 22 21 22 20 22 21 22 20 22 22 21 20 22 22 21 21 22 22 20 20 22 21 22 22 20 22 22 21 20 22 20 22 21 22 20 21 22 22 20 22 21 22 21 21 21 22 21 20 20 20 22 22 20 20 20 20 20 20 21 22 21 22 21 21 22 21 21 21 21 21 21 21 22 21 21 21 22 21 21 21
25 0 0 0 0 0 0 0 0 0 0 0 0 0 0 22 22 20 21 22 22 0 0 0 0 22 20 22 20 21 22 21 27 0 0 0 0 0 0 0 0 22 22 20 22 22 22 22 22 22 22 0 0 0 0 0 0 22 22 22 22 22 20 22 0 0 0 0 0 0 0 0 0 0 0 0 0 22 21 22 21 20 22 20 22 21 22 22 22 22 22 21 21 22 22 20 22 22 20 22 20 20 20 21 22 21 21 22 22 22 21 22 22 22 21 22 21 22 22 21 22 22 22 21 21
24 0 0 0 0 0 0 0 0 0 0 0 0 0 0 0 0 21 22 20 22 0 0 0 0 22 22 21 21 22 22 22 27 0 0 0 0 0 0 0 0 0 22 22 20 21 22 22 0 0 0 0 0 0 0 0 0 20 22 21 22 22 20 21 0 0 0 0 0 0 0 0 0 0 0 0 0 20 20 22 20 22 22 21 22 21 22 21 20 21 21 21 22 22 20 22 21 21 20 22 22 20 20 21 21 21 22 21 20 21 22 20 22 21 21 22 21 22 22 22 21 21 22 21 20
24 0 0 0 0 0 0 22 20 0 0 0 0 0 0 0 0 0 0 0 0 0 0 0 0 0 0 0 0 0 0 0 0 0 0 0 0 0 0 0 0 0 0 21 22 20 22 0 0 0 0 0 0 0 0 0 0 22 22 20 21 22 22 22 0 0 0 0 0 0 0 0 0 0 0 0 0 22 21 22 22 22 22 22 22 22 22 21 22 21 20 21 20 22 21 22 20 22 22 22 20 20 20 21 21 21 22 20 22 21 22 22 21 21 22 22 20 21 21 22 20 21 21 21 21
24 0 0 0 0 0 22 25 26 22 21 0 0 0 0 0 0 0 0 0 0 0 0 0 0 0 0 0 0 0 0 0 0 0 0 0 0 0 0 0 0 0 0 0 0 0 0 0 0 22 22 0 0 0 0 0 0 21 22 22 22 21 22 22 0 0 0 0 0 0 0 0 0 0 0 0 0 0 0 0 0 0 0 0 0 0 20 22 22 21 21 21 20 20 22 21 22 22 20 20 20 20 20 21 21 22 21 22 20 22 22 21 22 22 22 21 21 22 21 22 22 21 21 21 21
24 0 0 0 0 22 21 22 20 21 20 0 0 0 0 0 0 0 0 0 0 0 0 0 23 22 20 21 22 20 21 22 22 22 21 22 21 22 22 0 0 0 0 0 0 0 0 0 22 22 22 0 0 0 0 0 0 21 22 20 22 22 22 22 0 0 0 0 0 0 0 0 0 0 0 0 0 0 0 0 0 0 0 0 0 0 22 21 22 21 20 22 20 22 22 22 22 20 21 21 21 22 21 21 21 21 22 22 22 21 21 21 22 21 22 20 21 21 22 21 22 21 21 21 20
20 0 22 22 22 24 22 20 22 21 22 0 0 0 0 0 0 0 0 0 0 0 23 23 22 21 20 20 20 22 22 22 22 22 22 22 22 22 22 21 22 20 20 20 22 22 20 22 21 22 22 20 22 0 0 0 21 20 20 22 22 20 21 22 0 0 0 0 0 0 0 0 22 21 20 22 22 20 22 21 21 0 0 22 20 22 22 20 20 21 20 22 21 22 22 20 20 20 21 0 0 0 0 0 0 0 0 0 0 0 0 0 0 0 0 0 0 0 0 0 0 0 0 21 20
20 0 21 24 21 21 20 20 20 20 27 0 0 22 22 21 22 20 20 20 22 22 21 22 22 22 22 22 22 20 22 20 22 22 21 22 21 22 22 20 22 22 20 22 21 21 22 22 0 0 0 0 0 0 0 21 22 22 21 22 20 0 0 0 0 0 0 0 0 0 21 22 20 22 22 22 20 22 21 20 22 0 0 22 20 21 22 20 22 22 20 21 20 22 22 20 20 20 22 0 0 0 0 0 0 0 0 0 0 0 0 0 0 0 0 0 0 0 0 0 0 0 0 22 20
20 0 21 24 24 21 21 21 20 23 20 21 21 21 22 22 20 21 21 21 20 21 21 21 20 0 0 0 22 22 22 22 22 22 22 22 22 22 22 20 22 20 20 21 22 20 20 22 22 22 0 0 0 0 0 0 22 22 0 0 0 0 0 0 0 0 0 0 0 0 22 22 22 22 22 22 22 22 22 22 22 0 0 20 20 21 22 21 21 21 22 21 20 20 20 20 20 20 22 0 0 0 0 0 0 0 0 0 0 0 0 0 0 0 0 0 0 0 0 0 0 0 0 21 22
20 0 21 24 24 21 21 21 20 23 20 21 21 21 22 22 20 21 21 21 20 21 21 21 20 0 0 0 22 22 22 22 22 21 22 22 22 22 22 20 22 21 22 22 21 20 22 22 22 22 0 0 0 0 22 22 22 0 0 0 0 0 0 0 0 0 0 0 0 0 21 20 21 20 20 22 21 20 20 22 22 0 0 22 20 22 20 20 22 22 21 21 21 20 22 20 22 20 21 0 0 0 0 0 0 0 0 0 0 0 0 0 0 0 0 0 0 0 0 0 0 0 0 22 20
20 0 21 24 24 21 21 21 20 23 20 21 21 21 22 22 20 21 21 21 20 21 21 21 20 0 0 0 22 22 22 22 22 22 22 22 22 21 22 22 22 21 22 22 22 21 22 22 21 22 0 0 0 0 0 0 0 0 0 0 0 0 0 0 0 0 0 0 22 21 22 20 20 22 20 20 22 20 20 22 22 0 0 22 20 22 20 22 20 20 22 20 22 21 22 21 20 22 22 0 0 0 0 0 0 0 0 0 0 0 0 0 0 0 0 0 0 0 0 0 0 0 0 22 20
20 0 21 24 24 21 21 21 20 23 20 21 21 21 22 22 20 21 21 21 20 21 21 21 20 0 0 0 22 22 22 22 22 21 22 22 22 21 22 20 22 22 20 22 22 22 21 20 22 21 22 0 0 0 0 0 0 0 0 0 20 20 0 0 22 21 0 0 22 22 22 20 20 20 21 20 22 20 22 22 22 0 0 20 22 20 20 22 21 22 20 21 22 22 20 21 20 22 22 0 0 0 0 0 0 0 0 0 0 0 0 0 0 0 0 0 0 0 0 0 0 0 0 22 21
20 0 21 24 24 21 21 21 20 23 20 21 21 21 22 22 20 21 21 21 20 21 21 21 20 0 0 0 22 22 22 22 22 22 22 22 22 22 22 22 21 22 22 22 20 22 22 22 22 22 22 22 21 20 20 22 22 21 20 22 21 21 22 20 21 22 22 22 21 22 22 22 21 22 22 22 22 20 21 22 20 0 0 22 22 20 20 22 22 21 21 20 21 20 21 21 22 22 22 0 0 0 0 0 0 0 0 0 0 0 0 0 0 0 0 0 0 0 0 0 0 0 0 22 21
20 0 21 24 24 21 21 21 20 23 20 21 21 21 22 22 20 21 21 21 20 21 21 21 20 0 0 0 0 0 0 0 0 0 0 0 0 0 0 0 0 0 0 0 22 20 22 22 22 22 22 22 22 22 22 20 22 22 22 22 22 21 21 22 22 22 22 22 22 22 22 22 22 22 22 20 22 20 20 22 20 0 0 22 22 21 22 20 22 20 20 21 22 21 22 22 20 22 22 0 0 0 0 0 0 0 0 0 22 22 21 22 21 22 22 20 22 22 22 21 22 20 20 22 21
20 0 21 24 24 21 21 21 20 23 20 21 21 21 22 22 20 21 21 21 20 21 21 21 20 0 0 0 0 0 0 0 0 0 0 0 0 0 0 0 0 0 0 0 22 22 22 22 20 22 20 22 21 22 21 22 22 22 22 22 20 22 22 22 21 22 21 22 22 22 22 21 22 22 21 20 22 20 20 20 20 0 0 22 21 21 20 20 20 20 22 20 20 21 20 22 21 22 22 0 0 0 0 0 0 0 0 0 22 22 22 22 22 21 20 21 22 22 21 22 22 22 22 20 22
20 0 21 24 24 21 21 21 20 23 20 21 21 21 22 22 20 21 21 21 20 21 21 21 20 0 0 0 0 0 0 0 0 0 0 0 0 0 0 0 0 0 0 0 22 20 20 22 22 22 20 22 22 22 22 22 22 21 22 22 20 20 22 22 21 22 21 22 22 21 22 20 22 22 22 21 20 22 21 20 20 0 0 21 22 22 22 0 0 0 0 0 0 0 0 0 20 22 22 0 0 0 0 0 0 0 22 22 22 22 21 20 22 20 22 21 22 21 22 21 20 22 22 22 22
20 0 21 24 24 21 21 21 20 23 20 21 21 21 22 22 20 21 21 21 20 21 21 21 20 0 0 0 0 0 0 0 0 0 0 0 0 0 0 0 0 0 0 0 22 22 22 22 22 22 21 21 22 22 21 22 22 21 22 22 22 22 20 22 21 22 22 20 22 22 22 22 22 22 20 21 22 22 21 20 22 0 0 0 0 0 0 0 0 0 0 0 0 0 0 0 22 22 22 0 0 0 0 0 0 0 20 22 22 22 22 22 20 20 22 22 22 22 22 20 22 22 20 22 22
20 0 21 24 24 21 21 21 20 23 20 21 21 21 22 22 20 21 21 21 20 21 21 21 20 0 0 0 0 0 0 0 0 0 0 0 0 0 0 0 0 0 0 0 22 22 22 22 22 20 22 22 22 22 22 22 22 22 22 22 22 22 22 22 22 22 22 20 20 22 22 22 22 22 21 22 20 20 21 21 22 0 0 0 0 0 0 0 0 0 0 0 0 0 0 0 0 0 0 0 0 0 0 0 22 22 20 20 20 20 22 22 22 22 22 22 22 22 21 20 21 20 21 22 22
20 0 21 24 24 21 21 21 20 23 20 21 21 21 22 22 20 21 21 21 20 21 21 21 20 0 0 0 0 0 0 0 0 0 0 0 0 0 0 0 0 0 0 0 0 0 0 0 0 0 0 0 0 0 0 0 0 0 0 0 0 0 0 0 0 0 0 0 0 0 0 0 0 0 0 20 20 22 21 22 20 0 0 0 0 0 0 0 0 0 0 0 0 0 0 0 0 0 0 0 0 0 0 0 22 22 22 20 20 21 22 22 21 21 20 22 22 22 21 22 22 22 22 22 22
20 0 21 24 24 21 21 21 20 23 20 21 21 21 22 22 20 21 21 21 20 21 21 21 20 0 0 0 0 0 0 0 0 0 0 0 0 0 0 0 0 0 0 0 0 0 0 0 0 0 0 0 0 0 0 0 0 0 0 0 0 0 0 0 0 0 0 0 0 0 0 0 0 0 0 0 22 20 22 20 22 0 0 0 0 0 0 0 0 0 0 0 0 0 0 0 22 22 22 21 22 22 22 22 22 21 22 22 22 21 22 22 22 22 20 22 20 20 22 22 22 22 22 22 22
20 0 21 24 24 21 21 21 20 23 20 21 21 21 22 22 20 21 21 21 20 21 21 21 20 0 0 0 0 0 0 0 0 0 0 0 0 0 0 0 0 0 0 0 0 0 0 0 0 0 0 0 0 0 0 0 0 0 0 0 0 0 0 0 0 0 0 0 0 0 0 0 0 0 0 0 22 22 22 22 22 22 22 22 20 22 0 0 22 22 20 20 20 21 22 21 20 22 21 22 21 21 22 22 20 20 21 21 21 22 20 20 21 22 22 22 22 22 21 22 21 20 22 22 22
20 0 21 24 24 21 21 21 20 23 20 21 21 21 22 22 20 21 21 21 20 21 21 21 20 0 0 0 0 0 0 0 0 0 0 0 0 0 0 0 0 0 0 0 0 0 0 0 0 0 0 0 0 0 0 0 0 0 0 0 0 0 0 0 0 0 0 0 0 0 0 0 0 0 0 0 22 22 22 21 20 22 22 21 20 22 0 0 21 22 20 21 22 21 21 21 22 22 22 22 22 22 20 22 22 22 20 22 22 22 22 22 22 22 22 20 22 22 22 22 22 22 22 22 22
20 0 21 24 24 21 21 21 20 23 20 21 21 21 22 22 20 21 21 21 20 21 21 21 20 0 0 0 0 0 0 0 0 0 0 0 0 0 0 0 0 0 0 0 0 0 0 0 0 0 0 0 0 0 0 0 0 0 0 0 0 0 0 0 0 0 0 0 0 0 0 0 0 0 0 0 22 22 22 21 20 22 22 21 20 22 0 0 22 22 20 21 21 20 22 21 20 21 20 21 0 0 0 0 0 0 0 0 0 20 23 24 23 24 23 24 23 24 23 20 23 24 23 20 23
20 0 21 24 24 21 21 21 20 23 20 21 21 21 22 22 20 21 21 21 20 21 21 21 20 0 0 0 0 0 0 0 0 0 0 0 0 0 0 0 0 0 0 0 0 0 0 0 0 0 0 0 0 0 0 0 0 0 0 0 0 0 0 0 0 0 0 0 0 0 0 0 0 0 0 0 22 22 22 21 20 22 22 21 20 22 0 0 0 0 0 21 21 21 20 22 21 20 22 20 0 0 0 0 0 0 0 0 0 20 23 24 23 24 23 24 23 24 23 20 23 24 23 20 23
20 0 21 24 24 21 21 21 20 23 20 21 21 21 22 22 20 21 21 21 20 21 21 21 20 0 0 0 0 0 0 0 0 0 0 0 0 0 0 0 0 0 0 0 0 0 0 0 0 0 0 0 0 0 0 0 0 0 0 0 0 0 0 0 0 0 0 0 0 0 0 0 0 0 0 0 22 22 22 21 20 22 22 21 20 22 0 0 0 0 0 21 22 22 20 21 21 22 20 21 0 0 0 0 0 0 0 0 0 20 23 24 23 24 23 24 23 24 23 20 23 24 23 20 23
20 0 21 24 24 21 21 21 20 23 20 21 21 21 22 22 20 21 21 21 20 21 21 21 20 0 0 0 0 0 0 0 0 0 0 0 0 0 0 0 0 0 0 0 0 0 0 0 0 0 0 0 0 0 0 0 0 0 0 0 0 0 0 0 0 0 0 0 0 0 0 0 0 0 0 0 22 22 22 21 20 22 22 21 20 22 0 0 22 22 20 21 22 22 21 20 21 21 22 20 0 0 0 0 0 0 0 0 0 20 23 24 23 24 23 24 23 24 23 20 23 24 23 20 23
20 0 21 24 24 21 21 21 20 23 20 21 21 21 22 22 20 21 21 21 20 21 21 21 20 0 0 0 0 0 0 0 0 0 0 0 0 0 0 0 0 0 0 0 0 0 0 0 0 0 0 0 0 0 0 0 0 0 0 0 0 0 0 0 0 0 0 0 0 0 0 0 0 0 0 0 22 22 22 21 20 22 22 21 20 22 0 0 0 0 0 0 0 0 0 0 0 0 0 0 0 0 0 0 0 0 0 0 0 20 23 24 23 24 23 24 23 24 23 20 23 24 23 20 23
20 0 21 24 24 21 21 21 20 23 20 21 21 21 22 22 20 21 21 21 20 21 21 21 20 0 0 0 0 0 0 0 0 0 0 0 0 0 0 0 0 0 0 0 0 0 0 0 0 0 0 0 0 0 0 0 0 0 0 0 0 0 0 0 0 0 0 0 0 0 0 0 0 0 0 0 22 22 22 21 20 22 22 21 20 22 0 0 0 0 0 0 0 0 0 0 0 0 0 0 0 0 0 0 0 0 0 0 0 20 23 24 23 24 23 24 23 24 23 20 23 24 23 20 23
20 0 21 24 24 21 21 21 20 23 20 21 21 21 22 22 20 21 21 21 20 21 21 21 20 0 0 0 0 0 0 0 0 0 0 0 0 0 0 0 0 0 0 0 0 0 0 0 0 0 0 0 0 0 0 0 0 0 0 0 0 0 0 0 0 0 0 0 0 0 0 0 0 0 0 0 22 22 22 21 20 22 22 21 20 22 22 22 20 0 22 22 21 22 22 21 21 20 21 21 22 20 22 22 22 22 22 22 21 22 22 20 20 22 22 21 22 21 22 22 21 22 20 22 22